.....##.#.....#........#....##.
....#...#...#.#.......#........
.....##.#......#.......#.......
...##.........#...#............
........#...#.......#.........#
..........#......#..#....#....#
..................#..#..#....##
.....##...#..#..#..#..#.##.....
..##.###....#.#.........#......
#.......#......#......#....##..
.....#..#.#.......#......#.....
............#............#.....
...#.#........#........#.#.##.#
.#..#...#.....#....##..........
##..........#...#...#..........
...........#...###...#.......##
.#..#............#........#....
##.#..#.....#.......#.#.#......
.##.....#....#.#.......#.##....
..##...........#.......#..##.#.
##...#.#........#..#...#...#..#
.#..#........#.#.......#..#...#
.##.##.##...#.#............##..
..#.#..###......#..#......#....
.#..#..#.##.#.##.#.#...........
...#....#..#.#.#.........#..#..
......#.#....##.##......#......
#....#.##.##....#..#...........
...#.#.#.#..#.#..#.#..#.##.....
#.....#######.###.##.#.#.#.....
..#.##.....##......#...#.......
..#....#..#...##.#..#..#..#..#.
.............#.##....#.........
.#....#.##.....#...............
.#............#....#...#.##....
.#.....#.##.###.......#..#.....
.#...#.........#.......#..#....
..#.#..#.##.......##...........
.....##..#..#..#..#.##..#.....#
..##............##...#..#......
...#..#....#..##.....##..#.#...
#.....##....#.#.#...#...#..##.#
#.#..#.........#.##.#...#.#.#..
.....#.#....##....#............
#.......#..#.....##..#...#...#.
.....#.#...#...#..#......#.....
..##....#.#.#.#.#..#...........
##..#...#.........#......#...#.
..#...#.#.#.#..#.#.##..##......
#............###.....###.......
..........#...#........###.....
.......##...#...#...#........#.
.#..#.##.#.....................
.#..##........##.##...#.......#
.......##......#.....#......#..
.##.#.....#......#......#......
#...##.#.#...#.#...............
........#..#...#.##.......#....
...................#...#...##..
...#...#.........#.....#..#.#..
.###..#........#..##.##..#.##..
#...#.....#.....#.....#..#..#..
###..#.....#.#.#.#......#....#.
#........#....##.#...##........
.#.#..##........##....##.#.#...
#...#....#.###.#.#.........#...
...#...##..###.......#.........
......#....#..##..#.....#.#....
........#...##...###......##...
..........##.#.......##........
...#....#......#...##.....#....
###.#.....#.#..#..#....#...#..#
.#.....#.#....#...............#
..#....#....####....###....#.#.
....##........#..#.##.#....#...
.......##...#...#..#....####...
#...##.#......##...#..#........
..##..#.##....#.......##.#.#...
..#.#...............#...#.#....
....#.....#.#.....#.##.......#.
...#.#..##.#.#..............##.
..#.....#...#.............#.##.
##..#.#...#........#..#.....##.
...........##...#.#.###...#....
...#.#.#..#..................#.
.#...##.............#...#......
..#..#...#.#.......#...#.....#.
..##.......#.#.................
.##..#........###.....#....#.##
......#..###.......#....##....#
....#.....#.................#..
........#...#...#..............
...#..#.###.......#..#.#.#.##..
..#...#.....#....#.........#...
...#.............#........###..
......#..............#......#..
#..#...........#...#..........#
...##...#.###..#...#.....#.#...
....#..##......#.......##......
....#....##.#...#.#..#....#...#
.#...........#..#....##...#..##
..#.#.................###.#...#
..#.#.#...##...........#.......
..........#..##...#.#..##....##
........#........#.##..#.#...#.
.....#...##.......##......#...#
....#...#..#..#.....#..........
.#..#......#..#..#..###.......#
.##..........#...#...#.#.....##
..#..........#.#.#...###.......
....#................#...##....
.##..#....#..........#.#.#.....
..##...#.#........#.....#.##...
....####.....#..#.........##..#
......#.........#...#..........
....#...................#..##..
.##....#.#.........#....#...#..
....##...##.....#..####........
..##.#....#.#.......##...#.....
#...#.#.#...#..#..##.....#.....
#..................###.....#...
#.#.....#.......#.#...###.#....
.#..#....#............#........
#.#....#..#.#...............#..
..#..#..#.............#......#.
..#.......##...................
.#....#.........#....#.#.#..#..
....#....#..#...............#..
......#..#..##......#.........#
..#.##........##......#..#..#.#
#.....#.#....#.........##...#..
###..............#....###...##.
....#..##......#.......##......
......#...#.##......##....#..#.
..........#....#..##.......#..#
.#..#...##..#...........#..#..#
.....#....#...#..###...###....#
.#####..#...#.#.#..#.#.###...##
..##............##.#...#.##...#
.##..#...#...#....##.#..#..##..
.#....#...#............##..#...
.#.#......#....#....#..##..##..
.........#...#.......#.##..#...
#.........#.....##.....#..#..#.
...##.#...#...#..#..#....##..##
.#............#...#....##......
..#...#.##.........#.#......#.#
....#.##........#.........#..##
#.........#......#.#......#..#.
........#.#.......#.#........#.
..#..........##.#...#..#.#.....
..#...#....#...#...#..#.#..#.#.
.#.........#....#..#####..#....
#.#....#.#.###...#.............
..##...........##......##......
#.....#..#....#...............#
...#.#..#....##......#...##....
...#........#.....#...#..#.....
.#......##.........#......#....
..#..###.##...#.#.....#........
.............#......#..#.......
..#...............#.#...#..#..#
.......#..#...#.#####......#..#
.........#.....#...............
##........#............#.#.....
.#...#.....#..#..#...#....#...#
..#....#....##......##.....#.#.
#...##..##......#...#....#.....
....#.#.#.....###....##.##....#
..........##...##.......#......
..#.......#...##.#....##.##....
....#........................#.
...#...#.#.##...#.....#...#..#.
.#....##..#..#..........##..##.
.#.....#..#...#.##.....#.......
.#.##...#.#..#.....##....#...#.
.##...#........##....#..#......
.....#........#..........#.#..#
....#..##.......#..#.....#.....
...........#...#........#.##..#
.....#..#....#..#.#.....#....##
.....#....#.##.#..##...........
...##.......##.........#.......
...............##..#....#.#....
.......###..#........#..####.##
.......#.##...#.#....#.####....
....#...............#..........
##.#.......#.....#......#...#..
......##.....#....#.....#..#..#
.....#...##.............#......
#.#.##.#.....#..#........#.....
......##....#..#........#......
............#........#..#.#....
##.......#......#...####..#.##.
..##..#...#.............#.##...
.....#..##......#.##......###..
............#........#........#
#.#.#.#...#.#.....#.........#..
.........#...............#.....
.............###.#.......#....#
###.##..#..#..........#....#...
#......#...#..#..#.....#.##....
............#....#....#..#.....
..#.#....#...#......#.#..#..##.
...#........................#..
#.#...#..........#......#.#....
.........#................#...#
##.....#....#........##.......#
#...##........#...#...........#
...#...#..........##.......#.#.
..#.#.#....#......##...........
...#.#...#.##.#..#.#.##........
#....##.....###..#.......#.....
###.....#.#.#...#..#.........##
..#......#..###...#.#.#.....#.#
.#....#.....#............#..##.
....#....##..........#.....##..
#...........#....#...#..#...##.
..#.......#.....#..........#...
.#..#................#......#..
..#......#.#...#..#.#....#....#
...#..#...###..#..##....#.#....
..#..............#.....#.......
...#.#...#.........#.#.........
##......##...........##.#.##..#
..#..##..#....#.#......#.#...##
...#.###....###...#.....#......
#.#................#......#....
..#.....#.....#....##.......#..
.#.#...............##..#.......
...#....#.......#.#.....##..#..
.........#....#.......#.#...##.
#....#......##.#.........##...#
#.............#..##.#.#..##....
...#....#..#...#....#.#.#.#...#
.#....#....#..##.....#.#...###.
##............#.#...##.#..#.#..
##.#....##.....#..#..###....#..
##....#................##......
...##..#...#..###....#.....##..
.#...##......#..#.#.....#...#..
..##......##...#.##.......#....
......#.....#.....##........#.#
##....#...........#............
#.......#....#..#.##..##.#..#..
.#....##.#.....#..#..#.........
.#....#.#.#...#.....##.....#.#.
.......##.#.#........#......##.
##........#.##.......#...#..#..
...###..##....#.#....#.#.......
......#.......#...##.....#...#.
..#......##.#......#.....#.....
.....#.....###...#.............
#...#.#...#...#..#......#......
#.....#.......###.#....###.#...
...#.......#....####....##..#..
#.#.....#....#........#.......#
.........#.......#......#.#...#
..##....#.....##...............
..........#..#.#..#......#.....
..................##...##.#....
........#.......#...#..#.#.#...
.....#.#..##..#..#.#..#.......#
.....#........#..#..#....#....#
##............#..#..#...#....#.
.....#....................##..#
........##.#....###............
##.......#.##................#.
.....###.#..#..#...#....###.##.
.#......#.#....#.....##.#......
...##......##.........#...#....
....####..............#........
#...#.#..##..##.........##.....
......#......#....#..#.........
#.....#.....#.##...............
..#.##..#...##.#.####..#....###
#..#......#....#.##..##...#.#..
#....#.......#.....#.....#.#...
##.......#.....##...#.....#....
...#...##..........#..##..##..#
.###..#..##...#....#...#..#....
......##..###.......###...#....
....#...#.#.......#.##...##..##
#.#......#..##.#.#..#..#..#....
......#........#.......#.......
..........#.#.....##...........
......#..#........#..#.#..###..
##..#.............##..#........
.........#....#.....#.........#
.....#..##...#..#..##.##......#
###..#...........#.......#....#
...............#....#.#........
.##.#...#.#........##....#.....
.##.###...##..###....#...#...#.
.##..#....#.#.#...#.#.#.#...#..
.###.#...#.......#....#..#.....
..#..#.#.#.#........#.....##...
.#.......#.#...#.#...........##
...#.....##....#.....##...#....
................#.....####...#.
.#.#......#.......##...#.##....
.###.........#.#......#..#.#...
#......#...#....#..##.......#..
.##..#....#..#...........#...#.
.#...#.......##........#.##....
..#...........#...##...........
.....##....##......#....#..#...
#......#.#...#.##.#...##....#..
#....................#...##...#
..#............#........#......
.............#.........##.....#
...#...#......##.#...#...#.#...
..#...#.#.................#....
....##...#....#...###.##......#
...#....#...#..#...#....#.....#
...##.#........#..#.........#..
..##.....#..##...#.....##...#..
#.........#.#.#...#......#...#.
#.#...........#...#..#..#..##..
..#..#..##....#..........#.###.
.....#..#....#.#...#...#..#..#.
###.....#..#.................#.
.#..##.##.#......#....##..#....